%s ago=%s 以前
%s used of %s %s %%=已使用 %s/%s，%s %%
1 m=1 分鐘
10 s=10 秒
2 m=2 分鐘
30 s=30 秒
5 m=5 分鐘
Abort background operation=終止後台操作
Abort background process=終止後台進程
Active tunnels=活動隧道
Activity=活動
ago=以前
Airflow=風扇資訊
Alert Message=警報資訊
Alerts=警報
All Apps=顯示所有容器(Docker)應用
All VMs=顯示所有虛擬機
Array Information=磁碟陣列資訊
Attention - operation continues in background=注意 - 操作在後台繼續進行
Battery charge=電池電量
BIOS dated=BIOS 日期
Check free space=檢查剩餘空間
checking=檢查中
Click to toggle CPU chart=單擊以切換 CPU 視圖
Click to toggle details=單擊以切換詳細資訊
Clock is synchronized using %s NTP servers, time offset is %s %s=時鐘使用 %s NTP 伺服器同步，時間調整為 %s %s
Clock is synchronized using %s PTP server, time offset is %s %s=時鐘使用 %s PTP 伺服器同步，時間調整為 %s %s
Clock is unsynchronized with no NTP servers=時鐘未與 NTP 伺服器同步
Clock is unsynchronized with no PTP servers=時鐘未同步，無PTP伺服器
Clock is unsynchronized, free-running clock=時鐘不同步，自由運行時鐘
Clock synchronized with %s NTP server=時鐘已與 %s 個 NTP 伺服器同步
Clock synchronized with %s NTP servers=時鐘已與 %s 個 NTP 伺服器同步
Clone=複製
Close Tile=關閉磁貼
Completed=已完成
Containers=容器
Content Management=內容管理
Counters info=計數器資訊
Current operation %s on %s=當前操作 **%s** 於 **%s**
custom image=自訂鏡像
Data is invalid=數據無效
default image=默認鏡像
device warning=設備警告
device warnings=設備警告
Docker Containers=Docker 容器
Docker folder=Docker文件夾
Docker vdisk=Docker虛擬磁碟
Due in=剩餘時間
Edit VM after clone=複製後編輯虛擬機
Elapsed time=已運行時間
emulated=模擬
Errors info=錯誤資訊
Estimated finish=預計完成
failed device=故障設備
Fan count=風扇數
Fan Information=風扇資訊
FAN=風扇
Finding %s error=已發現: **%s** 個錯誤
Finding %s errors=已發現: **%s** 個錯誤
Flash device=快閃記憶體設備
Free=空閒
General info=常規資訊
Go to CPU pinning settings=轉到 CPU 綁定設置
Go to date and time settings=前往日期和時間設定
Go to disk settings=轉到磁碟設置
Go to Docker settings=轉到 Docker 設置
Go to fan settings=轉到風扇設置
Go to identification settings=轉到標識設置
Go to network settings=轉到網路設定
Go to scheduler settings=轉到計劃程序設定
Go to Share settings=轉到共享設置
Go to UPS settings=轉到 UPS 設置
Go to User settings=轉到用戶設置
Go to VM settings=轉到虛擬機設置
Go to VPN settings=轉到 VPN 設定
Handshake=握手
has=有
healthy=運行良好
heat warning=過熱警告
Hide details=隱藏詳細資訊
in progress=進行中
Inactive tunnels=非活動隧道
inactive=非活動
Inbound=下行速率
Information=資訊
Interface Information=介面資訊
invalid device=無效設備
invalid devices=無效設備
Last check completed on %s=上次完整檢查於**%s**
Last check incomplete on %s=上次不完整檢查於**%s**
Last checked on %s=上次檢查於**%s**
Legend=圖例
Lock sortable items=鎖定可分揀項目
Log filesystem=日誌檔案系統
Maximum size=最大大小
Memory Utilization=記憶體使用
Mode of operation=操作模式
Motherboard Information=主板資訊
Network traffic=網路流量
New VM=新虛擬機
Next check scheduled on %s=下次檢查計劃於**%s**
No docker containers defined=沒有定義的 Docker 容器
No running docker containers=沒有正在運行的 Docker 容器
No running virtual machines=沒有正在運行的虛擬機
No shares present=不存在共享
No virtual machines defined=沒有定義的虛擬機
Nominal power=額定功率
not received=未接收
Notices=提示
Notifications=通知
Only PNG images are allowed=只允許使用 PNG 格式的圖像
Outbound=上行速率
Output voltage=輸出電壓
Overall Load=整體負載
Overwrite=覆蓋
Parity disk not present=不存在奇偶校驗磁碟
Parity disks not present=不存在奇偶校驗磁碟
Parity has not been checked yet=目前未進行奇偶校驗
Parity Information=奇偶校驗資訊
Parity is degraded=奇偶校驗已降級
Percent of total used memory=總記憶體使用百分比
Percent usage of Docker folder=Docker 文件夾使用百分比
Percent usage of Docker vdisk=Docker 虛擬磁碟使用百分比
Percent usage of flash usb device=快閃記憶體 USB 設備使用百分比
Percent usage of LOG file system=日誌檔案系統使用百分比
Pool=池
Popup Blocked=Popup Blocked.
Power Status=電源資訊
Power=電源
Processor Information=處理器資訊
Put system to sleep=系統睡眠
RAM usage=記憶體使用
Reboot the system=系統重啟
Receive counters=接收計數器
Received packets=已接收封包
Runtime left=剩餘運行時間
Scheduled parity check is disabled=計劃的奇偶校驗被禁用
Select Case Model=選擇機箱型號
Select time frame=選擇時間範圍
Services=服務
Share count %s with %s cache only and %s encrypted=共享總計 **%s** 個，**%s** 個僅快取，**%s** 個已加密
Shares Information=共享資訊
Show details=顯示詳細資訊
Show Information=顯示資訊
ShowHide All Content=顯示/隱藏所有內容
ShowHide Content=顯示/隱藏內容
Shutdown the system=關閉系統
SMART error=S.M.A.R.T. 錯誤
SMART health-check failed=S.M.A.R.T. 健康檢查失敗
SMART=S.M.A.R.T.
sn=序號
Snapshot Name=快照名稱
Snapshot=快照
Start Cloned VM=啟動複製的虛擬機
Start the array=啟動磁碟陣列
Started only=僅顯示已啟動的
Stop the array=停止磁碟陣列
Temp=溫度
This may leave an unknown state=這可能會導致一個未知狀態
This will put the system to sleep=系統將睡眠
This will reboot the system=系統將重啟
This will shutdown the system=系統將關閉
This will start the array=磁碟陣列將啟動
This will stop the array=磁碟陣列將停止
Tile Management=標題管理
Transmit counters=傳輸計數器
Transmitted packets=已傳輸的封包
Unassigned Devices=未分配的設備
Unlock sortable items=解鎖可分揀項目
UPS Load=UPS 負載
UPS Model=UPS 型號
UPS status=UPS 狀態
Usable size=可用大小
User count %s with %s unprotected=用戶總計 **%s** 個，其中 **%s** 個未受保護
Users Information=用戶資訊
utilization warning=利用率警告
View Running Processes=查看正在運行的進程
Virtual Machines=虛擬機
VM Being Cloned=正在被複製的虛擬機
VM Clone=虛擬機複製
VM Name=虛擬機名稱
VPN Connections=VPN 連接
W=瓦特
Warnings=警告資訊
ZFS=ZFS

; Note: April 21, 2025 - 15 missing translations
FS Native Snapshot=
grandmaster=
heat warnings=
invalid=
master=
Memory dump=
No VMs running=
RX=
Share count %s with %s public SMB and %s public NFS=Share count: %s with %s public SMB and %s public NFS
SMART errors=
synching=
TX=
Unchecked will use QEMU External Snapshot=
utilization warnings=
Virtual Machines Usage=
