3rd Party=第三方
Access Mode=訪問模式
Add another Path, Port, Variable, Label or Device=添加另一個路徑、埠、變數、標籤或設備
Add Configuration=添加配置
Add=添加
Additional Requirements=額外要求
Addresses=地址
Always=總是
App to Host=應用到主機
Application=應用程式
apply update=應用更新
Are you sure=是否確定
Array must be Started to view Docker containers=必須**啟動**磁碟陣列才能查看 Docker 容器
Autostart=自動啟動
available=可用
Back=返回
Backup=備份
Beta=測試版
Books=書籍
By=來自
Categories=類別
Check for Updates=檢查更新
Cloud=雲
Compose=組成
Config Type=配置類型
Configuration not found=找不到配置
Connection Type=連接類型
Console shell command=控制台 shell 命令
Container ID=容器編號
Container IP=容器IP
Container not running=容器未運行
Container Path=容器路徑
Container Port=容器埠
Container Size=容器大小
Container=容器
Container not found Try reloading this page to fix=找不到容器,請嘗試重新載入此頁面以修復
CPU Memory load=CPU 記憶體負載
CPU Pinning=CPU 綁定
Created=已創建
Crypto Currency=加密貨幣
Default Value=預設值
DERP Relay=DERP 中繼
Device=設備
Display=顯示
DNS=DNS
Docker Containers=Docker 容器
Docker Hub URL=Docker Hub 網址
Docker Service failed to start=Docker 服務無法啟動
Downloaders=下載程序
Drivers=驅動
Edit Configuration=編輯配置
Error gathering Tailscale information from container=從容器中收集 Tailscale 資訊時出錯
Exit Node=退出節點
Exited=已退出
Expired RenewDisable key expiry=域名過期或自動續訂失敗
Extra Parameters=額外參數
Fixed IP address=固定 IP 地址
force update=強制更新
For security reasons, containers with Network Type Host should not have Tailscale enabled Please disable Tailscale in this container or change the Network Type of the container=出於安全原因,具有網路類型主機的容器不應啟用Tailscale. 請在此容器中禁用Tailscale或更改容器的網路類型
FTP=FTP
Game Servers=遊戲伺服器
healthy=健康
Hide Buttons=隱藏按鈕
Hide docker allocations=隱藏 Docker 分配
Hide more settings=隱藏更多設定
Home Automation=家庭自動化
Host Path=主機路徑
Host Port=主機埠
Hostname=主機名稱
HT=HT
Icon URL=圖示連結
Image ID=鏡像 ID
Is Exit Node=部署Exit Node
Key Expiry=金鑰到期
Key=鍵
Label=標籤
LAN IPPort=LAN IP:Port
Lock sortable items=鎖定可排序項目
Management=管理
MediaApp=媒體應用
MediaServer=媒體伺服器
Messenger=Messenger
Missing parameters=缺少參數
Music=音樂
Network Type=網路類型
No Docker containers installed=未安裝 Docker 容器
None Listed=未列出
of=的
Online=在線上
orphan image=孤立鏡像
Other=其他
Overview=概述
Path=路徑
Pause All=全部暫停
Photos=照片
Please check the logs and refresh the page=請檢查日誌並刷新頁面
Please check the logs=請檢查日誌
Port Mappings=埠映射
Port=埠
Post Arguments=發布參數
Privileged=特權
Productivity=生產力
Project Page=項目頁面
Proxy=代理
Pulling image=拉取鏡像
Read Me First=先閱讀此處
Read Only - Shared=只讀-共享
Read Only - Slave=只讀-從屬
Read Only=只讀
ReadWrite - Shared=讀/寫-共享
ReadWrite - Slave=讀/寫-從屬
Real Hostname=真實主機名稱
rebuild ready=重建就緒
rebuilding=正在重建
Remove template=移除模板
Removing container=正在移除容器
Removing orphan image=正在移除孤立鏡像
Repository=儲存庫
Required=必填
Reset sorting=重設排序
Resume All=全部恢復
Routes=線路
Save=保存
Select a template=選擇一個模板
Select categories=選擇類別
Show docker allocations=顯示 Docker 分配
Show more settings=顯示更多設定
Stable=穩定
Start All=全部啟動
starting up containers=正在啟動容器
Stop All=全部停止
Stopping container=正在停止容器
Successfully removed container=成功移除容器
Successfully removed orphan image=成功移除孤立鏡像
Successfully stopped container=成功停止容器
Support Thread=支持執行緒
Tailscale=Tailscale
Template URL=模板網址
Template=模板
The command failed=命令失敗
The command finished successfully=命令成功完成
TOTAL DATA PULLED=**拉取的數據總量**
Total size=總大小
Unknown action=未知操作
Unlock sortable items=解鎖可排序項目
Update All=全部更新
update available=可用更新
update ready=更新就緒
URL=網址
Value=值
Variable=變數
Video=影片
Voip=Voip
Volume Mappings=卷映射
wait=等待
Was this container created using this plugin=是否使用此插件創建該容器
Web=Web
WebUI=WebUI
Writable=可寫
