also remove image=同時移除鏡像
Apply=應用
Are you sure=是否確定？
Cancel=取消
checking=正在檢查
Completely REMOVE=全部**移除**
Console=控制台
day=天
days=天
disk image and definition=硬碟的鏡像和定義
Disks=硬碟
Donate=捐贈
Done=完成
Edit=編輯
Execution error=執行錯誤
Force Stop=強制停止
Hibernate=休眠
Log for=此項目的日誌
log=日誌
Logs=日誌
More Info=更多資訊
No=否
OK=確定
Ok=確定
Pause=暫停
Proceed=繼續
Project Page=項目頁面
Read Me First=先閱讀此處
Remove container=移除容器
Remove definition=移除定義
Remove image=移除鏡像
Remove VM=移除虛擬機
Remove=移除
Restart=重新啟動
Resume=繼續
Start=啟動
Stop=停止
Support=支持
Update container=更新容器
Update=更新
Updating all Containers=正在更新所有容器
Updating the container=正在更新此容器
VNC Remote=VNC 遠程
WebUI=打開網頁圖形界面
Yes, delete it=確定刪除
Yes, update it=確定更新
Yes=是

; footer messages
Array Copying=硬碟陣列正在複製
Array Clearing=硬碟陣列正在清除
Array Starting=硬碟陣列正在啟動
Array Stopping=硬碟陣列正在停止
Mounting disks=正在掛載硬碟
Retry unmounting user shares=重試卸載用戶共享
Spinning up all drives=正在喚醒所有硬碟
Stale configuration=舊的配置
Starting services=正在啟動服務
Stopping services=正在停止服務
Starting Recycle Bin=正在啟動回收站
Stopping Recycle Bin=正在停止回收站
Sync filesystems=同步文件系統
Unmounting disks=正在卸載硬碟
Autostart disabled=自動啟動已禁用
Missing encryption key=缺失加密金鑰
Opening encrypted volumes=正在打開加密卷

; docker variables
Container Path=容器路徑
Container Port=容器埠
Container Variable=容器變數
Container Label=容器標籤
Container Device=容器設備
