A format is NEVER part of a data recovery or disk rebuild process and if done in such circumstances will normally lead to loss of all data on the disks being formatted=格式化**決不**會是數據恢復或磁碟陣列重建過程的一部分，如果在這種情況下進行格式化，通常會導致正在格式化的磁碟上的所有數據遺失
Aborted=已中止
Action=執行
Add Pool=添加池
Add Subpool=添加子池
Add ZFS Subpool=添加 ZFS 子池
Add=添加
All existing data on this device will be OVERWRITTEN when array is Started=陣列啟動時，此設備上的所有現有數據將被覆蓋
Array Devices=磁碟陣列設備
Array of %s devices=%s 設備的磁碟陣列
Array Operation=磁碟陣列操作
Attribute Name=屬性名稱
Attributes not available=屬性不可用
Attributes=屬性
auto=自動
Autotrim=自動 TRIM
Balance Status=負載均衡狀態
Balance=負載均衡
Blacklisted=已列入黑名單
Boot Device=引導設備
Boot system in UEFI mode=UEFI 模式下的引導系統
btrfs balance status=BTRFS文件系統負載均衡狀態
btrfs check status=BTRFS文件系統維護檢查狀態
BTRFS operation is running=BTRFS 操作正在運行
btrfs scrub status=btrfs 清理狀態
cache - Cache Devices=快取 - 快取設備
Canceled=已取消
Cannot contact key-server Please check your=無法聯繫金鑰伺服器，請檢查您的
Capabilities not available=功能不可用
Capabilities=功能
Caution=**Caution**
Check Filesystem Status=檢查文件系統狀態
Clear Stats=清除統計資訊
Clearing in progress=正在清除中
Click on FLASH above this message=點擊此條消息上方的 **FLASH** 按鈕
Click to spin down device=點擊以休眠設備
Click to spin up device=點擊以喚醒設備
Comments=注釋
complete=完成
Completed without error=已完成且無錯誤
completed=完成
Compression=壓縮
Configuration valid=配置有效
Convert to raid0 mode=轉換為 RAID 0 模式
Convert to raid1 mode=轉換為 RAID 1 模式
Convert to raid10 mode=轉換為 RAID 10 模式
Convert to raid1c3 mode=轉換為 RAID 1C3 模式
Convert to raid1c4 mode=轉換為 RAID 1C4 模式
Convert to raid5 mode see help=轉換為 RAID 5 模式 **請參閱幫助**
Convert to raid6 mode see help=轉換為 RAID 6 模式 **請參閱幫助**
Convert to single mode=轉換為單一模式
Copying=正在複製
corrected=已校正
Create an empty file system on the disks shown as Unmountable discarding all data currently on the disks and update parity to reflect this=在顯示為無法掛載的磁碟上創建空文件系統將丟棄當前磁碟上的所有數據，並更新奇偶校驗以反映這一點
creating Flash backup zip file this may take several minutes=正在創建隨身碟(Flash)備份 zip 文件，這可能需要幾分鐘
Creating Flash backup=正在創建隨身碟(Flash)備份
Creation error=創建錯誤
Critical disk temperature threshold=臨界磁碟溫度閾值
Critical disk utilization threshold=臨界磁碟利用率閾值
Critical NVME temperature threshold=NVMe 臨界溫度閾值
Critical SSD temperature threshold=SSD 臨界溫度閾值
Current operation %s on %s=當前操作 %s 在**%s**上進行
Current position=當前位置
Custom attributes use comma to separate numbers=使用逗號分隔自訂屬性的數字
Data-Rebuild in progress=正在進行數據重建
Date of purchase=購買日期
Date=日期
dedup - Deduplication Tables=去重 - 去重表
Delete Pool=刪除池
detected=檢測到
Device contents invalid, in standby mode spun-down=設備內容無效，處於待機模式（已停轉）
Device contents invalid=設備內容無效
Device encrypted and unlocked=設備已加密並已解鎖
Device encrypted=設備已加密
Device is disabled=設備已禁用
Device is missing disabled=設備遺失（已禁用）
Device is part of a pool=該設備屬於一個池
Device locked unknown error=該設備因未知錯誤而鎖定
Device locked wrong encryption key=該設備因加密金鑰錯誤而鎖定
Device to be encrypted=要加密的設備
Disable Spin down delay to run a SMART extended self-test=禁用停轉延遲後才可運行 S.M.A.R.T. 擴展自檢
Disk in parity slot is not biggest=奇偶校驗插槽中的磁碟不是容量最大的磁碟
Disk Log Information=磁碟日誌資訊
Disk-Clear in progress=正在清理磁碟
Do not use reserved names=不要使用保留名稱
Do not use user share names=不要使用用戶共享名稱
Download SMART report=下載 S.M.A.R.T. 報告
Dual parity valid requires ALL disks in their original slots=*雙奇偶校驗*要求**所有**磁碟都位於其原始插槽中
Elapsed time=經過的時間
Enable user share assignment=啟用用戶共享分配
encrypted=已加密
Encryption input=加密輸入
Encryption status=加密狀態
enter disk index and device name as applicable to your controller=輸入適用於您的控制器的磁碟索引和設備名稱
Enter new key=輸入新金鑰
Erase Device Content=擦除設備內容
Errors occurred - Check SMART report=發生錯誤 - 請檢查 S.M.A.R.T. 報告
Estimated finish=預計完成需要的時間
Estimated speed=預計速度
Existing content is permanently lost=現有內容會永久遺失
Failed=失敗
Feature=功能
File system status=文件系統狀態
File system type=文件系統類型
Finding %s error=尋找：**%s**錯誤
Finding %s errors=尋找：**%s**錯誤
Flag=標誌
Flash backup=隨身碟(Flash)備份
Flash device is set as public share=隨身碟(Flash)設備被設置為公共共享
Flash Device Settings=隨身碟(Flash)設備設定
Format Unmountable disks=格式化無法掛載的磁碟
Formatting=正在格式化
formatting=正在格式化
Free=可用空間
FS=文件系統
Global Configuration=全局配置
Hide=隱藏
Identification=標識
Identity is not available=識別不可用
Identity=身份
if checked, Start array but do not mount disks=如果選中，則啟動磁碟陣列但不掛載磁碟
If this is a new array, move the largest disk into the parity slot=如果這是一個新的磁碟陣列, 請在 *奇偶校驗* 插槽中分配容量最大的硬碟
If you are adding a new disk or replacing a disabled disk, try Parity-Swap=如果要添加新磁碟或替換被禁用的磁碟，請嘗試奇偶校驗交換 (Parity-Swap)
Incorrect confirmation=確認不正確
Information=資訊
Insufficient free disk space available=可用磁碟空間不足
Interrupted=已中斷
Invalid configuration=無效的配置
invalid device=無效設備
invalid devices=無效設備
Invalid expansion=無效的擴展
Invalid pool name=無效的池名稱
Invalid, missing or expired=無效、遺失或過期
is only available when array is Started in Maintenance mode=僅當陣列在**維護模式**下啟動時才可用
is only available when array is Started=僅在陣列啟動時可用
Keyfile=金鑰文件
Last check completed on %s=上次檢查完成時間為**%s**
Last check incomplete on %s=上次檢查未完成日期為**%s**
Last checked on %s=上次檢查時間為**%s**
Last SMART test result=上次 S.M.A.R.T. 測試結果
logs - ZFS Intent Log=日誌 - ZFS意圖日誌
Maintenance mode=維護模式
Maintenance Mode=維護模式
Maintenance=維護
Manufacturing date=製造日期
Menu View=菜單視圖
Minimum free space=最小可用空間
mirror=鏡像
Missing Cache disk=缺少快取磁碟
Missing disk=缺少磁碟
Missing key=缺少金鑰
Missing pool disk=缺少池磁碟
Missing=缺少
Mounted=已掛載
Mover is running=Mover 正在運行
network settings=網路設定
New data disks detected=檢測到新數據磁碟
next device=下一個設備
No array data disks have been assigned=未分配任何陣列數據磁碟
No data disks=沒有數據磁碟
no devices=沒有設備
No parity check history present=沒有奇偶校驗歷史記錄
No self-tests logged on this disk=此磁碟上沒有記錄任何自檢
Not installed=未安裝
Not present=不存在
OK=確定
Once copy completes, the array may be Started, to initiate Data-Rebuild of the disabled disk=複製完成後，可以啟動陣列，以啟動被禁用磁碟的數據重建。
operation=操作
Options see Help=選項（參見幫助）
Otherwise use the keyfile method for UTF8 input=否則，請對 UTF-8 輸入使用**keyfile**方法
Parity disks content will be overwritten=*奇偶校驗* 磁碟內容將被覆蓋
Parity is already valid=奇偶校驗已生效
Parity Operation History=奇偶校驗操作歷史
Parity operation is running=正在運行奇偶校驗
Parity valid requires ALL disks to have their original content=*奇偶校驗* 要求**所有**磁碟包含其原始內容
Parity-Check in progress=正在進行奇偶校驗
ParityRead-Check History=奇偶校驗/讀取檢查歷史記錄
Parity-Sync in progress=正在同步奇偶校驗
Parity-SyncData-Rebuild in progress=正在進行奇偶校驗-同步/數據-重建
Partition format=分區格式
Partition size=分區大小
Passed=直通
Passphrase=密碼
Perform full balance=處理全部剩餘空間
Permit UEFI boot mode=允許 UEFI 引導模式
Please change share SMB security=請更改 SMB 共享安全性
Please check your system settings to support UEFI boot mode=請檢查您的系統設置以支持 UEFI 引導模式
Please try again=請重試
Pool Devices=池設備
Pool name already exists=池名稱已存在
Pool of %s devices=該池包含 %s 個設備
Pool Status=儲存池狀態
Power=電源
Preclear in progress=正在進行預清除
previous device=前一個設備
Printable Characters Only=僅可列印字元
Proceed to start=繼續開始
raid0=raid0
raid1=raid1
raid10=raid10
raid1c3=raid1c3
raid1c4=raid1c4
raid5=raid5
raid6=raid6
raidz=raidz
raidz2=raidz2
raidz3=raidz3
Raw Value=原始值
Raw View=原始視圖
Read errors corrected=已修復讀取錯誤
Read errors detected=檢測到讀取錯誤
Read-Check in progress=正在進行讀取檢查
Reading=讀取中
Reboot in safe mode=以安全模式重啟
Registration Key Manager=註冊金鑰管理器
registration key=註冊金鑰
ReiserFS is deprecated, please use another file system=ReiserFS 已被棄用, 請使用其他文件系統
reiserfsck status=reiserfsck 狀態
Rename Pool=重命名池
Repair corrupted blocks=修復損壞的塊
Replacement disk installed=已安裝替換磁碟
Replacement disk is too small=替換磁碟太小
Retype passphrase=重新輸入密碼
Schedule=計劃任務
Scrub Status=清理狀態
Scrub=清理
See %s Settings=參閱 %s 設置
self-test in progress=正在進行自檢
Self-Test=自檢
Server boot mode=伺服器引導模式
Set default boot menu=設置默認引導菜單
show passphrase=顯示密碼
Show=顯示
single=單
Slots=插槽
SMART attribute notifications=S.M.A.R.T. 屬性通知
SMART controller type=S.M.A.R.T. 控制器類型
SMART error log=S.M.A.R.T. 錯誤日誌
SMART extended self-test=S.M.A.R.T. 擴展自檢
SMART health-check failed=S.M.A.R.T. 運行狀態檢查失敗
SMART notification tolerance level=S.M.A.R.T. 通知等級
SMART notification value=S.M.A.R.T. 通知值
SMART self-test history=S.M.A.R.T. 自檢歷史記錄
SMART self-test in progress=正在進行 S.M.A.R.T. 自檢
SMART Settings=S.M.A.R.T. 設置
SMART short self-test=S.M.A.R.T. 簡短自檢
SMART status=S.M.A.R.T. 狀態
spares - Hot Spares=備用 - 熱備件
special - Special Allocation Class=特殊 - 特殊分配類
Speed=速度
Spin down delay=延遲休眠
Spin Down=休眠
Spin Up=喚醒
Spinup groups=喚醒磁碟陣列
Started, array protected=已啟動，磁碟陣列受保護
Started, array unprotected=已啟動，磁碟陣列未受保護
Started, clearing=已啟動，清理中
Started, formatting=已啟動，格式化中
Starting, copying=已啟動，複製中
Starting=正在啟動
Stopping=正在停止
Sync errors corrected=同步錯誤已更正
Sync errors detected=檢測到同步錯誤
Sync errors=同步錯誤
Sync=同步
Syslinux Configuration=Syslinux 配置
Syslinux configuration=Syslinux 配置
Temp=溫度
The array will be immediately available, but unprotected since parity has not been assigned=磁碟陣列將立即可用，但**未受保護**，因為尚未分配 *奇偶校驗* 磁碟
The array will be immediately available, but unprotected until Parity-Sync completes=磁碟陣列將立即可用，但**未受保護**，這種狀態將延續到奇偶校驗同步完成為止
The replacement disk must be as big or bigger than the original=替換磁碟的容量必須大於或等於原始磁碟
This is typically done when a new disk is added to the array to get it ready for files to be written to it=當將新磁碟添加到陣列中以使其準備好將文件寫入其中時，就可以完成此操作
This Unraid OS release has been withdrawn and may no longer be used Please=此 Unraid OS 版本已被撤回，並可能不再使用。請
This will ERASE ALL device content=這將**擦除**設備中的**所有**內容
This will ERASE content of ALL devices in the pool=這將**擦除**儲存池設備中的**所有**內容
This will reboot the system=這將重啟系統
This will shutdown the system=這將關閉系統
This will stop the array=這將停止磁碟陣列
This will stop the running operation=這將停止正在運行的操作
Threshold=閾值
Title=標題
Toggle readswrites display=切換讀寫顯示
Too many attached devices Please consider upgrading your=連接的設備過多，請考慮升級您的
Too many wrong andor missing disks=錯誤和/或缺失的磁碟太多
Total size=總大小
Unassign ALL devices to delete this pool=取消分配**所有**設備以刪除此池
Unassigned Devices=未分配設備
Unavailable - disk must be spun up=不可用 - 磁碟必須喚醒
unavailable no parity-check entries logged=不可用。未記錄奇偶校驗條目
Unavailable=不可用
Unclean shutdown detected=檢測到不正常關機
Unmountable disk present=存在無法掛載的磁碟
Unmountable disks present=存在無法掛載的磁碟
Unmountable Encrypted volume present=無法掛載：存在加密卷
Unmountable Missing encryption key=無法掛載：缺少加密金鑰
Unmountable No file system=無法掛載：沒有文件系統
Unmountable No pool uuid=無法掛載：沒有池 UUID
Unmountable not btrfs pool=無法掛載：不是 btrfs 池
Unmountable Unsupported or no file system=無法掛載：不支持的文件系統或無文件系統
Unmountable Volume not encrypted=無法掛載：卷未加密
Unmounted=未掛載
Upgrading diskswapping parity=升級磁碟交換奇偶校驗
Use ASCII characters from space to tilde=使用從空格到波形符的**ASCII**字元
Use Default=使用預設值
Use default=使用預設值
Use only lowercase with no special characters or leadingtrailing digits=僅使用小寫字母，沒有特殊字元或前導/尾隨數字
use printable characters only=僅使用可列印字元
Used=已使用
Value=值
W=瓦特
WARNING canceling may leave the array unprotected=警告：取消操作可能會使陣列不受保護
Warning disk temperature threshold=警告磁碟溫度閾值
Warning disk utilization threshold=警告磁碟利用率閾值
Warning NVME temperature threshold=NVMe 警告溫度閾值
Warning SSD temperature threshold=SSD 警告溫度閾值
WARNING=警告
Warranty period=保固期限
will activate a clean system power down=將啟用系統正常關機
will activate a clean system reset=將啟用系統正常重啟
will bring the array on-line and start Clearing new data disks=將使磁碟陣列聯機並開始**清理**新數據磁碟
will bring the array on-line and start Data-Rebuild=將磁碟陣列聯機並開始**數據重建**
will bring the array on-line and start Disk-Clear of new data disks=將磁碟陣列聯機並開始**數據重建**
will bring the array on-line and start Parity-Check=將使磁碟陣列聯機並開始**奇偶校驗**
will bring the array on-line and start Parity-Sync andor Data-Rebuild=將使磁碟陣列聯機並啟動**奇偶校驗同步**和/或**數據重建**
will bring the array on-line and start Parity-Sync=將使磁碟陣列聯機並開始**奇偶校驗同步**
will bring the array on-line=將使磁碟陣列聯機
will copy the parity information to the new parity disk=將奇偶校驗資訊複製到新的奇偶校驗磁碟
will create a file system in all Unmountable disks=將在所有不可掛載的磁碟中創建文件系統
will delete the encryption keyfile=將刪除加密金鑰文件
will disable the missing disk and then bring the array on-line Install a replacement disk as soon as possible=將禁用缺失的磁碟，然後使陣列聯機。請盡快安裝替換磁碟
will expand the file system of the data disk if possible then bring the array on-line and start Data-Rebuild=將擴展數據磁碟的文件系統；如果可能，則將陣列聯機並開始數據重建
will immediately clear all disk statistics=將立即清除所有磁碟統計資訊
will immediately invoke the Mover=將立即調用遷移程序(Mover)
will immediately spin down all disks=將立即休眠所有磁碟
will immediately spin up all disks=將立即喚醒所有磁碟
will pause Data-Rebuild=將暫停數據重建
will pause Disk-Clear=將暫停磁碟清理
will pause Parity-Check=將暫停奇偶校驗
will pause Parity-Sync=將暫停奇偶校驗同步
will pause Read-Check=將暫停讀取檢查
will pause the Clearing=將暫停清除
will pause the Parity-Check=將暫停奇偶校驗
will pause the Parity-SyncData-Rebuild=將暫停奇偶校驗同步/數據重建
will pause the Read-Check=將暫停讀取-檢查
will record all disk information and bring the array on-line=將記錄所有磁碟資訊並使陣列聯機
will record all disk information, bring the array on-line, and start Parity-Sync=將記錄所有磁碟資訊，使陣列聯機並啟動奇偶校驗-同步
will remove the missing cache disk and then bring the array on-line=將移除缺失的快取磁碟，然後使陣列聯機
will remove the missing pool disk and then bring the array on-line=將移除缺失的池磁碟然後使陣列在線上
will resume Data-Rebuild=將恢復數據重建
will resume Disk-Clear=將恢復磁碟清除
will resume Parity-Check=將恢復奇偶校驗
will resume Parity-Sync=將恢復奇偶校驗同步
will resume Read-Check=將恢復讀取檢查
will resume the paused Clearing=將恢復暫停的清理
will resume the paused Parity-Check=將恢復暫停的奇偶校驗
will resume the paused Parity-SyncData-Rebuild=將恢復暫停的奇偶校驗同步/數據重建
will resume the paused Read-Check=將恢復暫停的讀取-檢查
will start Clearing new data disks=將啟動**清理**新數據盤
will start Data-Rebuild=將啟動**數據重建**
will start Disk-Clear of new data disks=將要開始新數據盤的**磁碟清理**
will start Parity-Check=將啟動**奇偶校驗**
will start Parity-Sync andor Data-Rebuild=將啟動**奇偶校驗同步**和/或**數據重建**
will start Parity-Sync=將啟動**奇偶校驗同步**
will start Read-Check of all array disks=將開始對陣列中所有磁碟進行**讀取檢查**
will stop Clearing=將停止清理
will stop Data-Rebuild=將停止數據重建
will stop Disk-Clear=將停止磁碟清理
will stop Parity-Check=將停止奇偶校驗
will stop Parity-Sync=將停止奇偶校驗同步
will stop Parity-SyncData-Rebuild=將停止奇偶校驗同步/數據重建
will stop Read-Check=將停止讀取檢查
will stop the Parity-Check=將停止奇偶校驗
will stop the Read-Check=將停止讀取-檢查
will take the array off-line=將離線(offline)磁碟陣列
Worst=最差
Write corrections to parity=將校正寫入奇偶校驗
Writes=寫入
Wrong key=錯誤金鑰
Wrong Pool State=儲存池異常
xfs_repair status=xfs 修復狀態
You may not add new disks and also remove existing disks=您不能添加新磁碟，也不能移除現有磁碟
your server=您的伺服器
zfs pool status=zfs 儲存池狀態
zfs=zfs

; Sleep plugin translations
Check this=檢查此處
for more information=了解更多資訊
Make sure your server supports S3 sleep=確保您的伺服器支持 S3 級別的睡眠
Sleep will immediately put the server in sleep mode=**Sleep** 將立即使伺服器進入睡眠模式
Sleeping=睡眠中
System in sleep mode=系統處於睡眠模式
This will put the system in sleep mode=這將使系統進入睡眠模式
wiki entry=Wiki 條目

; Note: April 21, 2025 - 24 missing translations
After renaming the pool, check that your shares are assigned to the proper primary and secondary storage locations=
After upgrading the volume may not be mountable in previous versions of Unraid=
btrfs filesystem usage=
cache - L2ARC=
Dirty log detected=
File system corruption detected=
Fix=
Ineligible to run this version of Unraid OS Please consider extending your=Ineligible to run this version of Unraid OS. Please consider extending your
logs - Separate Intent Log SLOG=logs - Separate Intent Log (SLOG)
loopback=
No array devices have been assigned=
No devices=
No file system corruption detected=
not set=
Renaming the pool will change the share storage allocations=
Rx=
special - Metadata storage=
The ZFS volume will be upgraded=
This operation cannot be reversed=
To confirm type %s=To confirm type: %s
Tx=
Upgrade Pool=
While there is some risk, if it is not possible to first mount the filesystem to clear the log, zeroing it is the only option to try and repair the filesystem, and in most cases it results in little or no data loss=
Zero Log=
