%s ago=%s 之前
%s is out of range minimum 1 maximum 65535=%s 超出範圍 最小值 1 最大值 65535
; Keep the original plugin name in settings
12 hours=12 小時制
24 hours=24 小時制
8023ad=802.3ad
a value of zero means no automatic closure=設置為 0 表示不自動關閉
Accumulation duration=累積時間
Accumulation frequency=累積頻率
Activate=啟用
Activated=已啟用
Activating=正在啟用
Active Directory Settings=活動目錄設置
Active Directory=活動目錄
active-backup=主動備份
AD account login=AD 帳戶登入
AD account password=AD 帳戶密碼
AD domain name=AD 域名
AD initial group=AD 初始組
AD initial owner=AD 初始所有者
AD join status=AD 加入狀態
AD short domain name=AD 短域名
Add Peer=添加 Peer
Add Route=添加路由
Add Tunnel=添加隧道
Add VLAN=添加 VLAN
Advanced=高級
Agent function=代理功能
Agents=代理
Alerts=嚴重
Allocation profile=分配配置詳情
Allow Remote Access=允許遠端存取
Allow=允許
Always On - Manual Port Forward=Always On - 手動配置埠轉發
Always On - UPnP=Always On - UPnP
and, the first and last characters must be alphanumeric=並且第一個和最後一個字元必須為字母數字
and=和
Any=任何
APC UPS Daemon user manual=APC UPS 子程序用戶手冊
APCsmart=APCsmart
Apply to activate Docker after Array is Started=陣列啟動後應用以啟用Docker
Apply to activate VMs after Array is Started=陣列啟動後應用以啟用虛擬機
Applying=應用
Array must be Stopped to change=硬碟陣列必須**停止**後才能更改
Array status notification=硬碟陣列狀態通知
Array status=硬碟陣列狀態
Assignment error=分配錯誤
Attention=注意
Attribute=屬性
Authentication method=身份驗證方式
auto=自動
Auto-close=自動關閉
automatic=自動
Autostart=自動開啟
Available notifications=可用通知
bad or missing key file=秘鑰文件損壞或遺失
Balance schedule=均衡計劃
balance-alb=平衡 - 自適應負載平衡
Balanced operation=平衡
balance-rr=平衡 - 輪循
balance-tlb=平衡 - 傳輸負載平衡
balance-xor=平衡 - 異或
Bar color - Text=條形顏色 - 文本
Bar color=條形顏色
Bar gray - Text=條形 (灰色) - 文本
Bar gray=條形 (灰色)
Basic=基礎
Battery Charge=電池電量
Battery level to initiate shutdown=觸發關機的電池電量閾值
Best performance=最佳性能
Best power efficiency=最佳能效
bfq=BFQ
Block group usage=塊組使用情況
Bonding members of=綁定其成員
Bonding mode=綁定模式
boost=boost
Both Web Virt-Manager Remote Viewer=Web虛擬機管理和遠程查看器
Both=兩者
bottom-left=左下
bottom-right=右下
Boxed=盒裝的
Bridging members of=橋接其成員
broadcast=廣播
Browser=瀏覽器
btrfs filesystem show=btrfs 文件系統顯示
btrfs scrub status=btrfs 清理狀態
btrfs vDisk=btrfs 虛擬硬碟
Cache disk not enabled=快取硬碟未啟用
Cache Settings=快取設置
Cannot provision cert that would overwrite your existing custom cert at=無法在此位置預配將覆蓋現有自訂證書的證書
Cannot renew a custom cert at=無法續簽自訂證書
Cannot renew cert until within 30 days of expiry=在到期後 30 天內無法更新證書
CA-signed certificate file=CA 簽署的證書文件
Caution=注意
Celsius=攝氏度
center=居中
Certificate expiration=證書到期時間
Certificate issuer=證書發行者
Certificate not valid for=證書不可用於
Certificate subject=證書主題
Certificate URL=證書網址
Certificate will not renew unless you are signed in to Unraidnet=證書不會自動更新, 除非您登錄到 Unraid.net
Change encryption key=更改加密金鑰
Change power mode=更改電源模式
Changes=更改
Changing key failed for disks=更改硬碟金鑰失敗
Check cable=檢查線纜
Check four times a day=每天檢查四次
Check once a day=每天檢查一次
Check once a month=每月檢查一次
Check once a week=每週檢查一次
Check twice a day=每天檢查兩次
Checking=正在檢查
CIDR optional=CIDR 選項
Click here to see the Unraid Wiki for more information=單擊此處查看 Unraid Wiki，以了解更多資訊
Click to invoke the Mover=點擊調用 Mover
Click to select PNG file=點擊選擇 PNG 文件
Click to Select=點擊選擇
Comma separated list of IPv4 and IPv6 IP addresses=用逗號分隔的 IPv4 和 IPv6 IP 地址列表
configure your router with a static route of=請配置您的路由器設置靜態路由
configure your router with port forwarding of port=配置您的路由器以進行埠轉發
configuring interface=配置界面
Confirm array stop command=確認陣列停止命令
Confirm reboot powerdown commands=確認重啟和關機命令
Confirm sleep command=確認睡眠命令
Confirmations=確認資訊
connect to any device on the VPN tunnel=連接到 VPN 隧道上的任何設備
connect to this server using IP address=使用 IP 地址連接到此伺服器
Connected to Unraid Connect Cloud=已連接到 Unraid Connect 雲
Console Options=控制台選項
Console Settings=控制台設置
Container=容器
Content=內容
Copy syslog to flash on shutdown=在關機時將系統日誌複製到快閃記憶體
Correct file system errors=修正文件系統錯誤
CPU Isolation A reboot is required to apply changes=CPU 隔離：需要重啟才能應用更改
CPU isolation is prohibited while system is running in SAFE MODE=當系統以**安全模式**運行時，禁止 CPU 隔離
CPU Isolation=CPU 隔離
CPU Pinning Docker=CPU 綁定 Docker
CPU Pinning VM=CPU 綁定虛擬機
CPU Pinning=CPU 綁定
CRAM-MD5=CRAM-MD5
Cumulative parity check=累積奇偶校驗
Current date and time=當前日期和時間
Current listening interfaces=當前監聽的網路介面
Current usage ratio=當前占用率
Custom attributes use comma to separate numbers=自訂屬性使用逗號分隔數字
Custom banner=自訂橫幅
Custom UPS cable=自訂 UPS 電纜
Custom=自訂
custom=自訂
D comma G dot=D （逗號）: G （點）
D comma G none=D （逗號）: G
D comma G space=D （逗號）: G （空格）
D dot G comma=D （點）: G（逗號）
D dot G none=D （點）: G
D dot G space=D （點）: G （空格）
Daily=每日
Data received=收到的數據
Data sent=發送的數據
Date and Time=日期和時間
Date format=日期格式
Day of the month=指定幾號
Day of the week=指定周幾
Day, D Month YYYY=星期，日月年
Day, DD.MM.YYYY=星期，日.月.年
Day, DD-MM-YYYY=星期，日-月-年
Day, MMDDYYYY=星期，月/日/年
Day, Month D, YYYY=星期，月 日, 年
Day, YYYY Month D=星期，年 月 日
Day, YYYY-MM-DD=星期，年-月-日
DD-MM-YYYY=日-月-年
Deactivate=停用
Deactivating=正在停用
Default appdata storage location=默認應用數據儲存位置
Default critical disk temperature threshold=默認硬碟溫度危險閾值
Default critical disk utilization threshold=默認硬碟利用率危險閾值
Default critical SSD temperature threshold=默認SSD溫度危險閾值
Default file system for Array disks=硬碟陣列的默認文件系統
Default ISO storage path=默認 ISO 儲存路徑
Default network bridge=默認網橋
Default network source=默認網路配置
Default partition format=預設分區格式
Default SMART attribute notifications=默認 S.M.A.R.T. 屬性通知
Default SMART controller type=默認 S.M.A.R.T. 控制器類型
Default SMART notification tolerance level=默認 S.M.A.R.T. 通知容錯級別
Default SMART notification value=默認 S.M.A.R.T. 通知值
Default spin down delay=默認休眠延遲
Default VM storage path=默認虛擬機儲存路徑
Default warning disk temperature threshold=默認硬碟溫度告警閾值
Default warning disk utilization threshold=默認硬碟利用率告警閾值
Default warning SSD temperature threshold=默認 SSD 溫度告警閾值
Default Windows VirtIO driver ISO=默認 Windows VirtIO 驅動程序 ISO
Define a TLS certificate=指定 TLS 證書
Delete directory=刪除目錄
Delete Image File=刪除鏡像文件
Delete Peer=刪除 Peer
Delete tunnel failed=刪除隧道失敗
Delete Tunnel=刪除隧道
Delete vDisk file=刪除虛擬硬碟文件
Delete VLAN=刪除 VLAN
Deny=否
Desired MTU=所需 MTU
Detailed=詳細
Device=設備
DHCP pool=DHCP 池
directory=目錄
Disable AutostartStart option for VMs=禁用虛擬機的自動啟動/啟動選項
Disabled until connected to Unraid Connect Cloud=在連接到 Unraid Connect 雲之前禁用
Disk Settings=硬碟設置
Display array totals=顯示陣列總數
Display device name=顯示設備名稱
Display position=顯示位置
Display Settings=顯示設置
Display width=顯示寬度
Display world-wide-name in device ID=在設備 ID 中顯示通用名稱
DNS Propagation is PENDING=DNS 傳播正在**等待中**
DNS Rebinding Protection is ENABLED=已**開啟** DNS 重綁定保護
DNS servers=DNS 伺服器
docker containers on custom networks need static routing=自訂網路上的 Docker 容器需要靜態路由
Docker custom network type=Docker 自訂網路類型
Docker data-root=Docker 默認儲存路徑
Docker directory=Docker 目錄
Docker LOG maximum file size=Docker 日誌最大檔案大小
Docker LOG number of files=Docker 日誌檔案數
Docker LOG rotation=Docker 日誌輪換
Docker only=僅限 Docker
Docker PID Limit=限制 Docker 進程數
Docker service=Docker 服務
Docker Stop Timeout=Docker 停止超時
Docker storage driver=Docker 儲存驅動
Docker update notification=Docker 更新通知
Docker update=Docker 更新
Docker vDisk location=Docker 虛擬硬碟位置
Docker vDisk size=Docker 虛擬硬碟大小
Docker version=Docker 版本
Docker VMs=Docker + 虛擬機
Docker volume info=Docker 卷資訊
Docker will be available after Array is Started=啟動陣列後 Docker 可用
Docker=Docker
Dont show RDP option=不顯示 RDP 選項
download error=下載錯誤
Download Windows VirtIO driver ISO=下載 Windows VirtIO 驅動程序 ISO
Downloading=正在下載
Downstream=下游
Drag-n-drop a PNG file or click the image at the left=拖放 PNG 文件或單擊左側的圖片
Dumb=簡易
Duplicate port entered=輸入了重複的埠
Dynamix color theme=Dynamix 顏色主題
eg=例如
Email recipients=電子郵件收件人
Email subject prefix=電子郵件主題前綴
Email=電子郵件
enable advanced settings view=啟用進階設定視圖
Enable auto start=啟用自動啟動
Enable bonding=啟用綁定
Enable bridging=啟用橋接
Enable container table readmore-js=啟用容器頁面的 readmore-js
Enable disk shares=啟用硬碟共享
Enable Docker=啟用 Docker
Enable NetBIOS=啟用 NetBIOS
Enable NFS=啟用 NFS
Enable NVME power monitoring=啟用 NVMe 電源監控
Enable Outgoing Proxy=啟用代理服務
Enable SMB Multi Channel=啟用 SMB 多通道
Enable SMB=啟用 SMB
Enable spinup groups=啟用喚醒陣列
Enable user shares=啟用用戶共享
Enable VLANs=啟用 VLAN
Enable VMs=啟用虛擬機
Enable WSD=啟用 WSD
encrypted=加密
Encryption Key Update=加密金鑰更新
Enhanced macOS interoperability=增強 macOS 互操作性
ensure the peer network is different from=確保 peer 網路不同於
ensure the peer networks are different from=確保 peer 網路不同於
Ensure the primary network card eth0 has an IP address=確保首選網路eth0網卡有IP位址.
Enter existing passphrase=輸入現有的密碼短語
Enter route + gateway + metric=輸入路由 + 閘道器 + 指標
Erase Pool=擦除 池
Ether=乙太網
Ethernet Port=乙太網埠
Event=事件
Every 2 hours=每 2 小時
Every 3 hours=每 3 小時
Every 4 hours=每 4 小時
Every 6 hours=每 6 小時
Every 8 hours=每 8 小時
Every day=每天
Every hour=每小時
Every month=每月
Every week=每週
exceeds Disk Shutdown=超過硬碟停機次數
Exclude listening interfaces=排除監聽的介面
Excluded disks=排除的硬碟
Execution error=執行錯誤
Existing encryption key=現有的加密金鑰
Fahrenheit=華氏度
Failed to open=打開失敗
Failed to stop=停止失敗
Failure to do so may result in your docker image suffering corruption at a later time=否則可能導致 Docker 鏡像日後損壞
Fast=高頻率
Favorites enabled=啟用收藏功能
File system corruption fixed=已修復文件系統損壞
Finished=已完成
First day=第一天
First week=第一週
Flash backup=快閃記憶體備份
Font size=字體大小
Fourth week=第四周
FTP server=FTP 伺服器
FTP Server=FTP 伺服器
FTP users=FTP 用戶
Full Balance recommended=建議進行全面平衡
gateway name or address=閘道器名稱或地址
Gateway=閘道器
Generate Key=生成金鑰
Generate Keypair=生成金鑰對
Global Share Settings=全局共享設置
Global SMART Settings=全局 S.M.A.R.T. 設置
GRUB Configuration=GRUB 配置
Hardware=硬體
Header custom background color=標題自訂背景顏色
Header custom meta text color=標題自訂元文本顏色
Header custom secondary text color=標題自訂次要文本顏色
Header custom text color=標題自訂文本顏色
Header menu=標題菜單
Header show description=標題顯示描述
HHMM=時：分
Hibernate VMs=休眠虛擬機
Hidden share names are not allowed=不允許隱藏共享名稱
Hide dot files=隱藏 (**.**) 文件
Host access to custom networks=自訂主機訪問網路
Hostname from DNS reverse lookup=主機名（通過 DNS 反向尋找獲取）
Hostname from syslog message=主機名（通過系統日誌中獲取）
hosts=主機
Hourly=每小時
HTML color code of 3 or 6 hexadecimal digits=三或六位十六進制數字的 HTML 顏色代碼
HTTP port=HTTP 埠
httpIPport or httphostport=http://IP:port 或 http://host:port
HTTPS port=HTTPS 埠
Huge=巨大
Identification=標識
IEEE 8023=IEEE 802.3
if you have trouble logging in, close all other tabs pointing to this server and clear your browsers cache=如果您在登錄過程中遇到問題, 請關閉指向該伺服器的其他網頁然後清除瀏覽器的快取.
Import Tunnel=導入隧道
Importance=重要
In most cases, this should be your public WAN IPv4 instead=最常見的情況是, 這裡應該是您公網 IPv4 地址, 而不是
In most cases, this should be your public WAN IPv4=最常見的情況是, 這裡應該是您公網 IPv4 地址
In most cases, this should be your public WAN IPv6 instead=最常見的情況是, 這裡應該是您公網 IPv6 地址, 而不是
In most cases, this should be your public WAN IPv6=最常見的情況是, 這裡應該是您公網 IPv6 地址
inactive=不活躍
Include listening interfaces=包含監聽的介面
Included disks=包含的硬碟
Incorrect existing key=現有金鑰錯誤
Input a IPv4 address=輸入 IPv4 地址
Input a IPv6 address=輸入 IPv6 地址
Input a MAC address=輸入 MAC 地址
Input a NTP server name, NTP pool name or IP address=輸入 NTP 伺服器名稱、 NTP 池名稱或 IP 地址
Input the correct date and time manually=手動輸入正確的日期和時間
Interface description=接口說明
Interface Extra=額外介面
Interface Rules=介面規則
Invalid data=無效數據
Invalid email address=無效的電子郵件地址
Invalid IPv4 gateway=無效的 IPv4 閘道器
Invalid IPv4 range=無效的 IPv4 範圍
Invalid IPv4 subnet=無效的 IPv4 子網
Invalid IPv6 gateway=無效的 IPv6 閘道器
Invalid IPv6 range=無效的 IPv6 範圍
Invalid IPv6 subnet=無效的 IPv6 子網
Invalid pool address=無效 池 地址
Invalid subnet size=無效子網大小
IP address or FQDN=IP 地址或 FQDN
IP Address=IP 地址
IPv4 address A.B.C.D=IPv4 地址 A.B.C.D
IPv4 address assignment=IPv4 地址分配
IPv4 address=IPv4 地址
IPv4 custom network on interface=網路介面上自訂 IPv4 網路
IPv4 default gateway=IPv4 默認閘道器
IPv4 DNS server assignment=IPv4 DNS 伺服器分配
IPv4 DNS server=IPv4 DNS 伺服器
IPv4 IPv6=IPv4 IPv6
IPv4 network=IPv4 網路
IPv4 only=僅 IPv4
IPv4nn or IPv6nn route=IPv4/nn 或 IPv6/nn 路由
IPv6 address assignment=IPv6 地址分配
IPv6 address nnnnxxxxyyyy=IPv6 地址 nnnn:xxxx::yyyy
IPv6 address=IPv6 地址
IPv6 custom network on interface=網路介面上自訂 IPv6 網路
IPv6 default gateway=IPv6 默認閘道器
IPv6 DNS server assignment=IPv6 DNS 伺服器分配
IPv6 DNS server=IPv6 DNS 伺服器
IPv6 network=IPv6 網路
IPv6 only=僅 IPv6
IPv6 privacy extensions=IPv6 隱私擴展
ipvlan=ip vlan
is a self-signed certificate, ignore the browsers warning and proceed to the GUI=是自簽名證書, 忽略瀏覽器的安全性警告然後繼續打開圖形用戶界面
is a self-signed certificate, ignore the browsers warning when using this certificate=是自簽名證書, 使用該證書時請忽略瀏覽器的安全性警告
is down=已關閉
is not in the=不在裡面
is only available when the filesyestem is mounted=僅在文件系統掛載時可用
Isolated CPUs=已隔離 CPU
Isolation=隔離
Join=加入
Key successfully changed=金鑰成功更改
Key=鍵
Keyfile=金鑰文件
kyber=kyber
LAN hub spoke access=區域網路中心與輻射式訪問
LAN to LAN access=點對點區域網路
Language update notification=語言更新通知
Language update=語言更新
Language=語言
Large=大
Last day=前一天
Last handshake=最後一次握手
Last week=上週
LE Cert Provisioned successfully=已成功提供預配 LE 證書
Leave=離開
Libvirt Log=Libvirt 日誌
Libvirt storage location=Libvirt 儲存位置
Libvirt vdisk size=Libvirt 虛擬硬碟大小
Libvirt version=Libvirt 版本
Libvirt volume info=Libvirt 卷資訊
License key required=需要許可證金鑰
List of peers=Peers 列表
List of VLANs contains duplicate VLAN numbers=VLAN 列表中包含重複 VLAN 編號
Listing height=清單高度
Loading=正在載入
Local access URLs=本地訪問網路地址
Local endpoint=本地埠
Local gateway uses UPnP=本地閘道器使用 UPnP
Local keyboard layout=本地鍵盤布局
Local master=本地主節點
Local name=本地名稱
Local private key=本地私鑰
Local public key=本地公鑰
Local screen blank time=本地螢幕空白時間
Local server configuration=本地伺服器配置
Local server uses NAT=本地伺服器使用網路地址轉換(NAT)
Local syslog folder=本地系統日誌文件夾
Local syslog maximum file size=本地系統日誌最大檔案大小
Local syslog number of files=本地系統日誌檔案數
Local syslog port=本地系統日誌埠
Local syslog rotation=本地系統日誌輪換
Local syslog server=本地系統日誌伺服器
Local TLD=本地頂級域名
Local tunnel address IPv6=本地隧道的 IPv6 地址
Local tunnel address=本地隧道地址
Local tunnel firewall=本地隧道防火牆
Local tunnel network pool IPv6=本地隧道網路池的 IPv6 地址
Local tunnel network pool=本地隧道網路池
Lost communication=通信中斷
Low on battery=電池電量低
MAC address mismatch=MAC 地址不匹配
MAC address=MAC 地址
macvlan=mac vlan
Mail server port=電子郵件伺服器埠
Mail server=電子郵件伺服器
Make sure you understand what you are doing before enabling=在啟用之前, 請確保了解自己在做什麼
Manage password=管理密碼
Manage=管理
Management Access=管理權限
Management Interface=管理介面
mandatory=強制
Manual=手動
Medium=中頻率
member of=的成員
Metric=指標
Mirror syslog to flash=將系統日誌鏡像到快閃記憶體
Misconfiguration can cause problems=配置錯誤可能會導致問題
Missing new key=缺少新金鑰
Missing subnet size=缺少子網大小
MM-DD-YYYY=月-日-年
ModBus=ModBus
Modify with caution unable to validate path until Array is Started=謹慎修改: 硬碟陣列啟動前無法驗證路徑
Month of the year=指定幾月
Monthly=每月
Move now=立即啟動遷移
Mover is running=Mover 正在運行
Mover logging=Mover 日誌
Mover schedule=Mover 計劃
Mover Settings=Mover 設置
mq-deadline=mq-deadline
MTU size=MTU 大小
Multicast=多點廣播
Multi-function=多功能
Must be signed in to Unraidnet to provision cert=必須登錄到 Unraidnet 才能提供證書
name or ip address=名稱或 IP 地址
native=原始
Net=網
Network protocol=網路協議
Network Services=網路服務
Network Settings=網路設定
Never check=永不檢查
Never send=永不發送
New date and time=新日期和時間
NFS=NFS
No Balance required=無需均衡
No battery detected=未檢測到電池
No Cache device present=沒有快取設備
No Cache disk present=沒有快取硬碟
No change to report=沒有更改
No CPU pinning available. Docker service must be started=沒有可用的 CPU 綁定。必須先啟動 Docker 服務
No CPU pinning available. VM service must be started=沒有可用的 CPU 綁定。必須先啟動虛擬機服務
no name=未命名
No Parity disk present=沒有奇偶校驗硬碟
No Reply=未回復
No suitable interfaces found for PTP=未找到適合PTP的介面
Nominal Power=標稱功率
Non-tabbed=非選項卡式
Not activated=未啟用
Not allowed to assign ZERO cores=不允許分配**零**個內核
Not compatible with NetBIOS=與 NetBIOS 不相容
not configured=未配置
Not present=不存在
not received=未收到
not set=未設置
Not up-to-date=不是最新的
not used=未被使用的
Note=注釋
Nothing to do=不執行任何操作
Notices=常規
Notification Agents=通知代理
Notification entity=通知對象
Notification Settings=通知設定
Notifications display=通知顯示
NTP interval=NTP輪詢間隔
NTP server=NTP 伺服器
NTP=NTP
Number format=數位格式
Number scaling=數字縮放
Obtaining DNSv4 server=獲取 DNSv4 伺服器
Obtaining DNSv6 server=獲取 DNSv6 伺服器
Obtaining IPv4 address=獲取 IPv4 地址
Obtaining IPv4 gateway=獲取 IPv4 閘道器
Obtaining IPv6 address=獲取 IPv6 地址
Obtaining IPv6 gateway=獲取 IPv6 閘道器
obtaining=獲取中
On battery=正在使用電池
One or more paths do not exist=一個或多個路徑不存在
Online=在線上
Only alphanumeric characters=僅字母數字字元
Only modify if this is a new installation since this can lead to unwanted behaviour=否則可能引發意外情況，否則可能引發意外情況
Only PNG images are allowed=僅允許使用 PNG 格式的圖片
Oops=糟糕
optional metric lowest is preferred, 0 is no default gateway=可選指標 (首選最低指標, 0 表示無默認閘道器)
optional metric lowest is preferred=可選指標 (首選最低指標)
Optional=可選
or=或
Outgoing Proxy Manager=代理服務設定
Outgoing Proxy=代理服務
Output Voltage=輸出電壓
Override UPS Capacity Watts=覆寫 UPS 容量
Page view=頁面視圖
Parity Check=奇偶校驗
Passphrase=密碼短語
Password=密碼
Path does not exist=路徑不存在
PCIe ACS override=PCIe 訪問控制服務覆蓋
PCnet=PCnet
Peer allowed IPs=允許的對等節點IP
Peer DNS server=Peer DNS 伺服器
Peer endpoint=對等端點
Peer name=Peer 名稱
Peer preshared key=Peer 預分享秘鑰
Peer private key=Peer 私鑰
Peer public key=Peer 公鑰
Peer tunnel address IPv6=Peer 隧道的 IPv6 地址
Peer tunnel address=Peer 隧道地址
Peer type of access=Peer 連接類型
Peer update required=Peer 需要更新
Perform TRIM Operation=執行 TRIM 操作
Permit exclusive shares=允許獨占共享
Persistent Bash History=保留 Bash 歷史記錄
Persistent keepalive=保持連接
Ping=Ping
Placement of Users menu=用戶菜單的位置
Please consider re-applying all configurations=請考慮重新應用所有配置
Please disable the VM function=請禁用虛擬機功能
Please do this NOW=請**立即**執行此操作
Please enter a valid gateway=請輸入有效的閘道器
Please enter a valid range=請輸入有效範圍
Please enter a valid sending email address=請輸入有效的電子郵件發送地址
Please enter a valid subnet=請輸入有效的子網
Please match the requested format=請按照要求的格式提供
Please note that the flash backup is not encrypted at this time=注意, 此隨身碟備份未加密.
Please read the Help carefully=請仔細閱讀幫助文件
Please Reboot system to make new rules active=請**重啟**系統使得規則生效
Please Stop array to complete key installation=請停止硬碟陣列以完成秘鑰的安裝
Plugins update notification=插件更新通知
Plugins update=插件更新
Pool address is out of range=池地址超出範圍
pool device stats=池 設備狀態
Pool Device Status=池 設備狀態
Pool Information=池 資訊
Pool subnet size is not defined=未定義池子網大小
Pool subnet size is too large=池子網太大
Port %s is already in use by other services=%s 埠已被其他服務使用
Port %s is duplicated=%s 埠重複
Port %s is out of range minimum 1 maximum 65535=埠 %s 超出範圍（最小 1 最大 65535）
Port already in use=埠已在使用中
Port Down=埠關閉
Port out of range=埠超出範圍
Port Up=埠啟動
Power Mode=電源模式
Preserve user defined networks=保留用戶定義網路
Preset service=預設服務
Priority in header=標頭優先度
Protocol=協議
Provision=預配
PTP clock=PTP 時間
PTP interface=PTP 介面
PTP mode=PTP 模式
PTP profile=PTP 設定檔
PTP server=PTP 伺服器
PTP transport=PTP 傳輸方式
PTP=PTP
QEMU version=QEMU 版本
Questions See the documentation=有問題? 見<a href="https://wiki.unraid.net/Connect" target="_blank">文件</a>.
raidz1=RAID Z1
readmodifywrite=讀取／修改／寫入
recommended=推薦的
reconstruct write=重建寫入
redirects to=重定向到
Refreshing=正在刷新
Registration key required=需要註冊金鑰
Reinitialize=重新初始化
Reinitializing=重新初始化中
Remark configure your router with port forwarding of port=備註: 請在路由器中設置埠轉發
Remark to use the Dynamic - Manual Port Forward option for Remote Access please set Use SSLTLS to Strict in Management Access=備註: 要為遠端存取使用 "Dynamic - 手動配置埠轉發" 功能  請在訪問控制中將"使用 SSL/TLS"設置到"嚴格".
Remark to use the UPnP options please set Use UPnP to Yes in Management Access=備註: 要使用 UPnP 選項，請在訪問管理中將"使用 UPnP" 設置為 "是".
Remark=備註
Remote access to LAN=遠端存取區域網路
Remote access to server=遠端存取伺服器
Remote peer configuration=遠程 Peer 設置
Remote syslog port=遠程系統日誌埠
Remote syslog server=遠程系統日誌伺服器
Remote tunneled access=遠程隧道訪問
Remove pool=移除 池
Remove Pool=移除 池
Remove Windows VirtIO driver ISO=移除 Windows VirtIO 驅動程序 ISO
Replied=已回復
Required=規定
resolution=解析度
Restore default image=恢復默認鏡像
Retype new passphrase=重新輸入新的密碼短語
Route=路由
Routing Table=路由表
Rule=規則
Rules contain duplicate MAC address assignments=規則包含重複的 MAC 地址分配
Rules=規則
Runtime left to initiate shutdown=啟動關機程序前的剩餘運行時間
Runtime Left=剩餘運行時間
Samba extra configuration=Samba 額外配置
Scheduled parity check=計劃的奇偶校驗
Scheduler=計劃程序
Scrub schedule=清理時間表
Scrub Schedule=清理時間表
Scrub=清理
Second week=第二週
See Help for more details and workarounds=參閱幫助以獲取更多詳細資訊和解決方法
see interface=查看界面
Select existing keyfile=選擇現有的金鑰文件
Select new keyfile=選擇新的金鑰文件
Select Proxy=選擇代理
Self-signed certificate file=自簽名的證書文件
Self-signed or user-provided certificate=自簽名或用戶提供的證書文件
Send crash information to Unraid developers=向 Unraid 開發者發送崩潰資訊
Send every hour=每小時發送一次
Send every two hours=每兩小時發送一次
Send four times a day=每天發送四次
Send once a day=每天發送一次
Send once a month=每月發送一次
Send once a week=每週發送一次
Send three times a day=每天發送三次
Send twice a day=每天發送兩次
Sending email address=電子郵件發送地址
Server hub spoke access=伺服器中心與輻射式訪問
Server name=伺服器名稱
Server to server access=伺服器到伺服器訪問
Server was unable to provision SSL certificate=伺服器無法預配 SSL 證書
Set password=設置密碼
Setting disabled in safe mode=在**安全模式**下已禁用設置
Settings menu=設置菜單
Show array utilization indicator=顯示陣列利用率指示器
Show banner background color fade=顯示橫幅背景色漸變
Show banner=顯示橫幅
Show Dashboard apps=顯示儀錶板應用
show passphrase=顯示密碼短語
Show Peer Config=顯示 Peer 配置
Show RDP menu option=顯示 RDP 菜單選項
Show RDP option=顯示 RDP 選項
Show VM Usage=顯示虛擬機使用情況
Shutdown time-out=關機超時
Shutdown VMs=關閉虛擬機
shutdown=關機
Sign In to Unraidnet required=需要登錄 Unraid.net
Simple=簡單
slave=從機
Slow=低頻率
Small=小
Smart=智慧
SMB Extras=SMB 額外
SMB Settings=SMB 設置
SMB=SMB
SMTP Settings=SMTP 設置
SNMP=SNMP
Software=軟體
Sorry, an error occurred in processing your SSL certificate=抱歉，處理 SSL 證書時出錯
Sorry, an error occurred updating unraidnet DNS records=抱歉，更新 Unraid.net DNS 記錄時出錯
SSH port=SSH 埠
Start APC UPS daemon=啟動 UPS 守護進程
Start page=起始頁
Static=靜態
Stop %s to make changes, see=停止 **%s** 以進行更改，參見
Stop corresponding docker containers=停止相應的docker容器
Store notifications to flash=將通知儲存到隨身碟(flash)
Subject=主題
Subnet=子網
subnet=子網
success=成功
Summarized=簡潔
Switching the Storage Driver requires to delete and rebuild the Docker directory manually=切換儲存驅動程序可能需要手動刪除並重新構建Docker目錄
Syslog Server=系統日誌伺服器
System goes down=系統將要關機
System identifier for logfile name=日誌檔案名中的系統標識符
System notifications=系統通知
System Setting=系統設置
System Settings=系統設置
Tabbed=選項卡式
Tailscale Lets Encrypt certificate=Tailscale 的 Let's Encrypt（CA） 證書
Tailscale URLs=Tailscale 網址
TCP=TCP
TELNET port=TELNET 埠
Temperature unit=溫度單位
Template Authoring Mode=模板創作模式
Terminal font size=終端字體大小
Test running=測試運行
Test=測試
Text - Bar color=文本 - 條形（顏色）
Text - Bar gray=文本 - 條狀（灰色）
Text=文本
The Local endpoint does not resolve to an IPv4 address=本地端點無法解析為IPv4地址
The Local endpoint does not resolve to an IPv6 address=本地端點無法解析為IPv6地址
The Local endpoint resolves to=本地端點解析為
The Local tunnel network pool cannot be in=此本地隧道網路池無法使用
The Local tunnel network pool IPv6 cannot be in=本地隧道網路池中的IPv6不能在
Third week=第三週
This is required to create VMs in KVM=在 KVM 中創建虛擬機時必需
this mode requires a network switch with proper setup and support=此模式需要具備適當設置和支持的網路交換機
this must be the only peer in the tunnel and sole active tunnel when in use=在使用時，這必須是隧道中唯一的對等端和唯一的活動隧道
This removes any connections running over this tunnel=這將刪除通過此隧道運行的任何連接
This Unraid Server was unreachable from the outside=這個 Unraid 伺服器從外面是無法訪問的
This will unassign all devices from the pool but will NOT modify any device contents=這將從資源池中取消分配所有設備，但不會影響設備上的內容
Time format=時間格式
Time of the day=指定時間
Time on battery before shutdown=關機前的電池運行時間
Time state=時間狀態
Time sync=時間同步
Time zone=時區
time-out=超時
Timestamp=時間戳
TLS certificate location=TLS 證書位置
To test your manual port forward, temporarily configure Allow Remote Access as Always On - Manual Port Forward=為了測試您手動配置的埠, 請臨時將 '允許遠端存取' 設置為 'Always On - 手動配置埠轉發'
to=to
Toggle keys=切換秘鑰
Toggle thread to containers=將執行緒切換到容器
Toggle view=切換視圖
top-left=左上
top-right=右上
Trim Now=立即執行 TRIM
TRIM operation started=已開始 TRIM
TRIM schedule=TRIM 計劃表
TRIM Settings=TRIM 設置
trim=TRIM
Tunable enable Direct IO=是否啟用無快取讀寫
Tunable enable NCQ=設置NCQ模式
Tunable fuse_remember=設置 fuse 快取時間
Tunable md_num_stripes=設置 stripe 大小
Tunable md_queue_limit=設置隊列請求限制
Tunable md_sync_limit=設置同步操作限制
Tunable md_write_method=設置寫入操作模式
Tunable nr_requests=設置請求數量
Tunable poll_attributes=設置輪詢間隔
Tunable scheduler=設置調度程序
Tunable support Hard Links=是否開啟硬連結
Tunnel has running containers attached=隧道連接了正在運行的容器
tunnel is inactive=隧道處於非活動狀態
Tunnel wg0=隧道 wg0
Turn off UPS after shutdown=關機後關閉 UPS
Type new passphrase=輸入新的密碼短語
UDP=UDP
UDPv4=UDP v4
UDPv6=UDP v6
Unable to register this Unraid Server=無法註冊此 Unraid 伺服器
Unassigned Devices=未分配的設備
unavailable=不可用
Unicast=單獨廣播
Unlimited=無限的
Unraid Connect=Unraid Connect
Unraid Lets Encrypt certificate=Unraid Let's Encrypt 證書
Unraid OS update notification=Unraid 操作系統更新通知
Unraid OS update=Unraid 操作系統更新
Unraidnet account status=Unraid.net 帳戶狀態
Unraidnet Status=Unraid.net 狀態
Update DNS=更新 DNS
updating=正在更新
Updating=正在更新
Upgrade Cert=升級證書
Upgrade ZFS Pool=升級 ZFS 池
UPnP forwarding not set=UPnP 轉發未設置
UPnP state changed to=UPnP 狀態變為
UPnP tunnel is inactive=UPnP 隧道未啟用
Upon host shutdown=當主機關閉時
UPS cable=UPS 線纜
UPS Details=UPS 詳細資訊
UPS Load=UPS 負載
UPS Model=UPS 型號
UPS overloaded=UPS 過載
UPS Settings=UPS 設置
UPS Status=UPS 狀態
UPS type=UPS 類型
URL=網址
USB=USB
Use DEFAULT setting when public NTP servers are defined=指定公共NTP伺服器後，使用預設設置
Use image name dockerimg or docker-xfsimg or select a folder=使用鏡像名稱(docker.img 或者 docker-xfs.img)或者選擇一個文件夾
Use NTP=使用 NTP
Use only letters A-Z, digits or space,dash,underscore=只能使用字母 A-Z、數字、空格和下劃線
use printable characters only=只使用可列印字元
Use SSH=使用 SSH
Use SSLTLS=使用 SSL/TLS
Use STARTTLS=使用 TLS
Use TELNET=使用 TELNET
Use UPnP=使用 UPnP
Used Free columns=已使用/未使用列
User Preferences=用戶首選項
User root=root 用戶
User shares not enabled=用戶共享功能未啟用
User Utilities=用戶程序
User=用戶
Username=使用者名稱
user-set=用戶設置
uses=用戶
value must be a number=值必須是數字
Value=值
Very large=非常大
Very small=非常小
VFIO allow unsafe interrupts=VFIO 允許不安全的中斷
View libvirt log=查看 libvirt 日誌
View Local Config=查看本地配置
View Peer Config=查看對等節點配置
View the Docs for more information=查看文件以獲取更多資訊
view=查看
Virt-Manager Remote Viewer=虛擬機管理器遠程查看器
VLAN assignment mismatch=VLAN 分配不匹配
VLAN number=VLAN 編號
VM Manager=虛擬機管理器
VM manager=虛擬機管理器
VM Settings A reboot is required to apply changes=虛擬機設置 更改生效需要重新啟動。
VM shutdown time-out=虛擬機關閉超時
VM Usage refresh timerseconds=虛擬機使用情況刷新時間間隔（秒）
VM=虛擬機
VMs only=僅虛擬機
VMs will be available after Array is Started=虛擬機將在啟動陣列後可用
VPN Manager=VPN 管理器
VPN tunnel access for System=系統級的VPN隧道訪問
VPN tunnel for docker containers only=只供 Docker 容器使用的 VPN 隧道
VPN tunneled access for docker=Docker 使用的 VPN 隧道
VPN tunneled access for system=系統使用的 VPN 隧道
VPN tunneled access=VPN 隧道訪問
WAN Port=公網埠
Warnings=警告
Watts=瓦
Web interface=Web 界面
Week of the month=一月中的周
Weekly=每週
When running Unraid virtualized, there are no available power modes=運行虛擬化 Unraid 時，沒有可用的電源模式
WireGuard Configuration=WireGuard 配置
WireGuard URLs=WireGuard 網址
Workgroup Settings=工作組設置
Workgroup=工作組
Write corrections to parity disk=將糾正資訊寫入奇偶校驗盤
Wrong PTP server address=錯誤的 PTP 伺服器地址
WSD options experimental=WSD 選項（實驗性）
xfs vDisk=xfs 虛擬硬碟
Yearly=每年
You can not exclude this interface=您不能排除此介面
You must be signed in to Unraidnet in order to generate an Unraidnet SSL certificate=您必須登錄到Unraid.net才能生成Unraid.net的SSL證書
Your existing Docker image file needs to be recreated due to an issue from an earlier beta of Unraid 6=由於 Unraid 6 早期測試版中一個問題, 需要重新創建現有容器(Docker)的鏡像文件
Your hardware does not have Intel VT-x or AMD-V capability=您的硬體不具有 Intel VT-x 或 AMD-V 功能
Your Lets Encrypt SSL Certificate has been provisioned and a DNS record for local IP address=已設置您的 Let's Encrypt SSL 證書，及本地 IP 地址的 DNS 記錄
Your Lets Encrypt SSL Certificate has been renewed=您的 Let's Encrypt SSL 證書已更新
Your local IP address %s has been updated for unraidnet=您本地 IP 地址 %s 已經在 unraid.net 中更新
Your router or DNS server has DNS rebinding protection enabled, preventing=您的路由器或 DNS 伺服器已啟用 DNS 重新綁定保護，以防止
Your server has been registered=您的伺服器已經註冊
Your Unraid Server is reachable from the internet=您的伺服器已經可以從外部網路訪問
YYYY-MM-DD=年-月-日
zfs pool information=zfs 池資訊
zfs=zfs

; My Servers plugin
Account status=帳戶狀態
Also delete cloud backup Restore from backup will be unavailable=同時刪除雲端備份. 將不能從備份恢復.
Always - Manual Port Forward=總是 - 手動埠轉發
Always - UPnP=總是 - UPnP
Are you sure you want pause communication with your remote flash backup on unraidnet=您確定要暫停與 unraid.net 上遠程快閃記憶體備份的通信嗎？
Are you sure you want to delete your cloud backup Restore from backup will be unavailable=確定要刪除雲端備份嘛? 將不能從備份恢復.
Are you sure you want to delete your local flash backup=確定要刪除本地隨身碟(flash)備份嗎?
Are you sure you want to erase all change history in both local and unraidnet remote=您確定要刪除本地和 unraid.net 遠程中的所有更改歷史記錄嗎？
Connected to My Servers Cloud=連接到我的雲服務
Delete Cloud Backup=刪除雲端備份
Disabled until connected to My Servers Cloud=在連接到我的雲端服務前不可用
Disabled until you have signed in=在登錄前不可用
Disabled until you Provision a myunraidnet SSL Cert=在您提供 myunraid.net SSL 證書前不可用
Disabled until you Provision an unraidnet SSL Cert and set SSL-TLS to Auto=在您配置 unraid.net SSL 證書並將 SSL-TLS 設置為 Auto 之前不可用
Disabled until you Provision an unraidnet SSL Cert=不可用，直到您提供 unraid.net SSL 證書
Disabled until your root user account is password-protected=在您的 root 用戶帳戶受密碼保護之前不可用
Dynamic - Manual Port Forward=動態 - 手動埠轉發
Dynamic - UPnP=動態 - UPnP
Dynamic Remote Access allows you to do stuff that someone else can explain=動態遠端存取允許您做一些其他人可以解釋的事情
Enable Transparent 2FA for Local Access=開啟本地訪問的透明二步驗證
Enable Transparent 2FA for Remote Access=開啟遠端存取的透明二步驗證
In order to activate Flash Backup there must be at least 1GB of free space on your flash drive=在啟動本地隨身碟(flash)備份之前, 請保證有1GB以上的可用空間.
Local T2FA requires a myunraidnet certificate=本地訪問的透明二步驗證需要 *.myunraid.net 證書
Local T2FA requires Unraid 610 or higher and a myunraidnet certificate=本地訪問的透明二步驗證需要 Unraid 6.10 或更高系統版本, 以及 *.myunraid.net 證書
Local T2FA requires Unraid 610 or higher=本地訪問的透明二步驗證需要 Unraid 6.10 或更高系統版本
Local T2FA requires Use SSLTLS to be Auto and a myunraidnet certificate=本地訪問的透明二步驗證需要使用 SSL/TLS , 以及 *.myunraid.net 證書
Local T2FA requires Use SSLTLS to be Auto and Unraid 610 or higher=本地訪問的透明二步驗證要求使用 SSL/TLS , 以及 Unraid 6.10 或更高系統版本
Local T2FA requires Use SSLTLS to be Auto, Unraid 610 or higher, and a myunraidnet certificate=本地訪問的透明二步驗證要求使用 SSL/TLS 為自動，Unraid 6.10 或更高系統版本, 以及 *.myunraid.net 證書
Local T2FA requires Use SSLTLS to be Auto=本地訪問的透明二步驗證要求使用 SSL/TLS
More information=更多資訊
port=埠
Remote T2FA requires a myunraidnet certificate=遠端存取的透明二步驗證需要 *.myunraid.net 證書
Remote T2FA requires Remote Access to be enabled and a myunraidnet certificate=遠端存取的透明二步驗證需要啟用遠端存取和 *.myunraid.net 證書
Remote T2FA requires Remote Access to be enabled and Unraid 610 or higher=遠端存取的透明二步驗證需要啟用遠端存取, 以及 Unraid 6.10 或更高系統版本。
Remote T2FA requires Remote Access to be enabled, Unraid 610 or higher, and a myunraidnet certificate=遠端存取的透明二步驗證需要啟用遠端存取, Unraid 6.10 或更高系統版本, 以及一個 *.myunraid.net 證書
Remote T2FA requires Remote Access to be enabled=遠端存取的透明二步驗證需要啟用遠端存取功能
Remote T2FA requires Unraid 610 or higher and a myunraidnet certificate=遠端存取的透明二步驗證需要 Unraid 6.10 或更高系統版本, 以及 *.myunraid.net 證書
Remote T2FA requires Unraid 610 or higher=遠端存取的透明二步驗證需要 Unraid 6.10 或更高系統版本
The Unraid server is unreachable from outside your network Be sure you have configured your router to forward port=Unraid 伺服器無法通過公網訪問. 請確定已在路由器中配置正確的埠轉發
to the Unraid server at=連接到 Unraid 伺服器, 通過
Transient errors in this log can be ignored unless you are having issues=如果您沒有遇到問題, 則可以忽略此日誌中偶爾出現的錯誤
Unraid API extra origins=Unraid API 的額外來源
View Flash Backup Error Log=查看隨身碟(flash)備份錯誤日誌

; Note: May 31, 2025 - 48 missing translations
Add network=
Allow realtime updates on inactive browsers=
Allows the use of ethernet frames larger than 1500 bytes=
Connect Remote Access=
Connect to WiFi network=
Connectivity issues may occur when other devices do not support this feature=
Deselect All=
Disabled until connected to Unraid Connect Cloud - try reloading the page=
Duplicate metrics=
Enable default gateway=
Enable jumbo frames=
GraphQL API Developer Sandbox=
Hide=
Interface link=
Interface speed=
Interface=
Join this network=
List of default gateways contains duplicate metric values=
Manual input=
Max Server Protocol Version=
metric value, a lower value is more preferred=
Missing Network Name=
Missing=
My networks=
Network Info=
Network name=
NFSv3=
NFSv4=
No encrypted disks found=
Number of fuse File Descriptors=
Number of Threads=
Or if they are improperly configured, use this feature with care=
Other networks=
Otherwise use the keyfile method for UTF8 input=Otherwise use the **keyfile** method for UTF8 input
overlay2=
Printable Characters Only=
Receive bitrate=
Regulatory region=
Select All=
Show=
Signal level=
stripe=
Transmit bitrate=
Two letter country code=
Use ASCII characters from space to tilde=Use **ASCII** characters from space ' ' to tilde '~'
vcpu allocated to vm=
Wi-Fi=
Wireless=
