Add Share=添加共享
All files encrypted=所有文件已加密
All files protected=所有文件已受保護
All files unprotected=所有文件未受保護
Allocation method=分配方法
Array must be Started to view Shares=必須**啟動**磁碟陣列才能查看共享
Automatically split any directory as required=根據需要自動拆分任何目錄
Automatically split only the top five directory levels as required=根據需要僅自動拆分前五個目錄級別
Automatically split only the top four directory levels as required=根據需要僅自動拆分前四個目錄級別
Automatically split only the top level directory as required=根據需要僅自動拆分頂層目錄級別
Automatically split only the top three directory levels as required=根據需要僅自動拆分前三個目錄級別
Automatically split only the top two directory levels as required=根據需要僅自動拆分前兩個目錄級別
Clean Up=清除
CLEAN UP=清除
Comments=備註
Compute All=全部計算
Compute=計算
Disk Shares=磁碟共享
Do not use pool names=請勿使用 池 的名稱
Do not use reserved names=請勿使用 已保留 的名稱
Enable Copy-on-write=啟用寫入複製
Enter a name for the share=輸入共享名稱
Excluded disks=已排除的磁碟
Exclusive access=唯一訪問權
Export=共享
Fill-up=填滿
Free Space will be calculated=計算空閒空間
Free=可用
has been deleted=已被刪除
HDD=機械硬碟
High-water=High-water
Included disks=包含的磁碟
Invalid Characters=不可用的字元
Invalid share name=不可用的共享名稱
is missing=缺失
it references storage that does not exist=引用了不存在的儲存
It references storage that does not exist=引用了不存在的儲存
Manual do not automatically split directories=手動操作，不要自動拆分目錄
Minimum free space=最小可用空間
Missing share name=缺失共享名稱
Most-free=高可用
Mover action=Mover 操作
Mover takes no action=Mover 未執行操作
Mover transfers files from array to cache=Mover 將文件從磁碟陣列傳輸到快取
Mover transfers files from cache to array=Mover 將文件從快取傳輸到磁碟陣列
Mover transfers files from Primary storage to Secondary storage=Mover 將文件從主儲存傳輸到輔助儲存
Mover transfers files from Secondary storage to Primary storage=Mover 將文件從輔助儲存傳輸到主儲存
next user share=下一個共享用戶
No unused share configurations present=沒有未使用的共享配置
Not used=未被使用
Only=只在
Prefer=首選
previous user share=之前的用戶共享
Primary storage %s=主儲存 %s
Primary storage for new files and folders=新文件和文件夾的主儲存空間
Primary storage to Secondary storage=主儲存到輔助儲存
Read=讀取
Recompute=重新計算
Remove unused share configurations=移除未被使用的共享設置
Removed share configurations=移除共享設置
Rule=規則
Secondary storage to Primary storage=從輔助儲存到主儲存
Secondary storage=輔助儲存
Select cache pool=選擇快取池
Set when adding new share only=僅在添加新共享時設置
Share contains data=共享包含的數據
Share is empty and is safe to delete=共享資源為空可以安全刪除
Share is empty=共享為空
Share is outside the list of designated disks=共享位於指定磁碟列表之外
Share must be empty to be deleted=共享資源必須為空才能刪除
Share name contains invalid characters for ZFS use=共享名稱包含對ZFS使用無效的字元
Share Settings=共享文件夾設定
Share status=共享狀態
Size=大小
Some or all files unencrypted=部分或全部文件未加密
Some or all files unprotected=部分或全部文件未受保護
Split level=拆分級別
SSD=固態硬碟
Storage=儲存
There are no exportable disk shares=沒有可共享的磁碟共享
There are no exportable user shares=沒有可共享的用戶共享
There are no mountable array or pool disks - cannot add shares=沒有可安裝的硬碟陣列/硬碟池 - 無法添加共享
This share is invalid=共享無效
Time Machine volume size limit=時間機器卷大小限制
Unknown cache usage=未知快取使用情況
Unknown encryption state=未知加密狀態
Unknown protection status=未知保護狀態
Use cache pool for new filesdirectories=(對新文件/目錄)使用快取池
User Shares=用戶共享
Warning: Configured Pool=警告：池已配置
Write=寫入
You cannot use the following within share names=您不能在共享名稱中使用以下內容

; Note: April 21, 2025 - 1 missing translations
There are no mounted array or pool disks - cannot add shares=
