20 EHCI=2.0 (EHCI)
30 nec XHCI=3.0 (nec XHCI)
30 qemu XHCI=3.0 (qemu XHCI)
9p Mode=9p 模式
Advanced tuning options=高級最佳化設置
Allocation=分配
and if using graphics device passthrough it too needs UEFI=‌如果使用顯示卡直通，也需要UEFI支持
Are you sure=是否確定
Array must be started to view Virtual Machines=必須啟動硬碟陣列才能查看虛擬機
Autostart=自動啟動
Back=返回
Base Image=基礎鏡像
Block Devices=塊設備
Boot Order=啟動順序
Boot order=啟動順序
Bus=匯流排
Capacity=容量
CD1 ISO Image=CD1 ISO鏡像
CD2 ISO Image=CD2 ISO鏡像
Change Icon=更改圖示
Check free space=檢查剩餘空間
Cleanup=清理
Click and Select cdrom image to install operating system=選擇光碟鏡像以安裝操作系統
Clock Offset=時鐘偏差
Clocks Offset=時鐘偏差
Clocks=時鐘
Clone=複製
Config Folder=設定檔夾
Copy Paste Domain XML Configuration Here=在此處複製黏貼域 XML 配置
CPU Mode=CPU 模式
CPUs=CPU
Create=創建
CreateModify Template=創建/修改模板
Creating=正在創建
DateTime=日期時間
define if migratable=定義是否可遷移
define Multifunctiion Support=定義多功能支持
define OS boot options=指定系統啟動選項
define the amount memory=指定記憶體量
define the maximum amount of memory=指定最大記憶體量
define type of cpu presented to this vm=指定提供給此虛擬機的 CPU 類型
description of virtual machine=虛擬機描述
Description=描述
Discard=捨棄
Disk devices=硬碟設備
Disk devicesVolume=硬碟設備/卷
Disk IO=硬碟 I/O
Download Folder=下載文件夾
Download, Click and Select virtio drivers image=下載，並選擇 VirtIO 驅動鏡像
Downloading=正在下載
Edit VM after clone=複製後編輯虛擬機
eg=例如
Eject CD Drive=彈出 CD 設備
Emulated=模擬
Enable USB boot=啟用 USB 啟動引導
Enter name=輸入名字
ETA=預計時間
Evdev Device=Evdev 設備
Extracting=正在提取
File exists=File exists.
File write failed=File write failed.
Files being removed=文件移除中
Folder to save the LibreELEC image to=LibreELEC 鏡像保存至
Folder to save the OpenELEC image to=OpenELEC 鏡像保存至
Form View=表單視圖
free=可用
FS Native Snapshot=FS 原始快照
grab options=抓取設置
Grab Toggle=抓取切換
Grab=抓取
Graphics Card=顯示卡
Graphics ROM BIOS=顯示卡 ROM BIOS
Graphics=圖形
Guest agent not installed=用戶端代理程序未安裝
Guest CPU=用戶端 CPU
Guest not running or guest agent not installed=用戶端代理程序未安裝或未運行
Guest not running=用戶端未運行
Hide inline xml=隱藏內建 XML
Host CPU=主機 CPU
Host Passthrough=主機直通
Hyperv tweaks for Windows=針對 Windows Hyper-V 的調整
Hyper-V=Hyper-V
i440fx will work for most=‌i440fx 晶片組適用於大多數
Icon=圖示
If name already exists it will be replaced=如果名稱已存在，它將被替換
Initial=初始
Insert CD=插入CD
Insert=插入
Interfaces=介面
Invalid storage path=儲存路徑無效
Invalid VM to edit=嘗試編輯的虛擬機（VM）不存在
IP Address=IP 地址
ISO Image=ISO 鏡像
ISO storage path doesnt exist, please create the user share or empty folder first=ISO 儲存路徑不存在，你需要先創建共享用戶或文件夾
ISO storage path doesnt exist=ISO 儲存路徑不存在
ISO storage path was empty=ISO 儲存路徑無效
keyboard for VM Console=虛擬機控制台鍵盤
keyboard for VNC=VNC 鍵盤
Leaving blank will use OS name=如果留空，將使用系統名稱
LibreELEC Version=LibreELEC 版本
LibreELEC=LibreELEC
Libvirt Service failed to start=Libvirt 服務無法啟動
Location of virtual machine files=虛擬機檔案位置
Lock sortable items=鎖定可排序的項目
Logical CPUs=邏輯 CPU
Machine=機器
Manual=手動
Max=最大值
MD5 verification failed, your download is incomplete or corrupted=MD5 驗證失敗，下載未完成或已損壞
Memory dump=記憶體轉儲
Memory inuseCurrentMaximum=已用記憶體 / 可用記憶體 / 最大記憶體
Migratable=可遷移的
Mode=模式
mount tag inside vm=虛擬機掛載標籤
Multifunction=多功能
My Workstation=我的工作站
name of mount tag inside vm=虛擬機掛載標籤名稱
Name of virtual machine=虛擬機名稱
Network Bridge=網路橋接
Network IO=網路 IO
Network MAC=網路 MAC
Network Model=網路模式
Network Source=網路資源
New VM=新虛擬機
No CD image inserted in to drive=未在設備中插入CD映像
No CD image inserted into drive=驅動器中未插入CD鏡像
No GPU=無顯示卡
No Virtual Machines installed=未安裝虛擬機
None available=無可用
Not running=沒有運行
Not set=未設置
Only these special characters are valid Underscore _ Hyphen - Colon Period=Only these special characters are valid Underscore (_) Hyphen (-) Colon (:) Period (.)
OpenELEC Version=OpenELEC 版本
OpenELEC=OpenELEC
Optional=可選的
OS Install CDRom Bus=操作系統虛擬光碟匯流排類型
OS Install ISO=操作系統安裝 ISO 鏡像
Other PCI Devices=其他 PCI 設備
Other XML=其他 XML
Override Storage Location=覆蓋儲存位置
Overwrite=覆蓋
OVMF requires a UEFI-compatable OS=OVMF 需要與 UEFI 相容的操作系統
OVMF TPM=OVMF TPM
OVMF=OVMF
Parent=父項
password for VM Console=虛擬機控制台的密碼
password for VNC=VNC 密碼
path of Unraid share=Unraid 共享路徑
path on Unraid share to save LibreELEC settings=用於保存 LibreELEC 設置的 Unraid 共享路徑
path on Unraid share to save OpenELEC settings=用於保存 OpenELEC 設置的 Unraid 共享路徑
Path to ROM BIOS file=ROM BIOS 文件路徑
Pivot=支點
Please choose a folder the LibreELEC image will download to=請選擇 LibreELEC 鏡像將下載到的文件夾
Please choose a folder the OpenELEC image will download to=請選擇 OpenELEC 鏡像將下載到的文件夾
Pop-up Blocker is enabled Please add this site to your exception list=已開啟彈出視窗攔截, 請將本站點添加到允許彈出窗口白名單
port for virtual console=虛擬控制台埠號
Prefix=前綴
Present=當前
Primary=主要
protocol for virtual console=虛擬控制台協議
Q35 for a newer machine model with PCIE=Q35 適用於較新的 PCIE 設備
QEMU Command Line=QEMU命令行
QEMU64=QEMU64
random mac, you can supply your own=隨機 MAC，也可以自行設定
re-generate random mac address=重新生成隨機 MAC 地址
Remove all files=移除所有文件
Remove Images=移除鏡像
Remove LibreELEC image=移除 LibreELEC 鏡像
Remove Meta=移除元數據
Remove OpenELEC image=移除 OpenELEC 鏡像
Remove this LibreELEC file=移除此 LibreELEC 文件
Remove this OpenELEC file=移除此 OpenELEC 文件
Remove User Template=刪除用戶模板
Rename disabled, %s snapshots exists=重命名操作被禁用，已經存在 %s 個快照‌
Repeat=重複
Requires guest agent installed=需要安裝用戶端代理
Requires guest running=需要用戶端運行
SeaBIOS will work for most=SeaBIOS 適用於大多數
SeaBIOS=SeaBIOS
Select ISO image=選擇ISO鏡像
Select ISO=選擇ISO鏡像
Select ISOs for CDROMs=為虛擬光碟選擇 ISO 鏡像
Select the BIOS=選擇 BIOS
Select the LibreELEC version to use=選擇要使用的 LibreELEC 版本
Select the machine model=選擇機器型號
Select the OpenELEC version to use=選擇要使用的 OpenELEC 版本
Select the USB Controller to emulate=選擇要模擬的 USB 控制器
Select=選擇
Separate sub-folder and image will be created based on Name=基於名稱創建獨立子文件夾和鏡像
Serial=串列埠
Set discard option=設置捨棄選項
Set SDD flag=設置 SSD 標籤
shares=共享
Show Inline XML=顯示內建 XML
Snapshot Method=快照方式
Snapshot Name=快照名稱
Snapshot=快照
Snapshots being removed=正在刪除快照
Snapshots=快照
Some OSes wont support USB3=部分操作系統不支持 USB3.0
Sound Card=音效卡
Specify a ISO storage path first=先指定一個 ISO 儲存路徑
SSD=SSD
Start All=全部啟動
Start Cloned VM=啟動複製的虛擬機
Start VM after creation=創建後啟動虛擬機
Stop All=全部停止
Template exists=Template exists.
Template Name=模板名稱
Tickpolicy=時鐘策略
Timer Source=事件源
Toggle VM autostart=虛擬機自動啟動切換
Top Image=Top Image
Type Method=類型 (方式)
type of storage image=儲存鏡像類型
Unchecked will use QEMU External Snapshot=未選擇將使用 QEMU 外部快照
Unknown action=未知操作
Unknown version=未知版本
Unlock sortable items=解鎖可排序的項目
Unraid Mount tag=Unraid 掛載標籤
Unraid Mount Tag=Unraid 掛載標籤
Unraid Share Mode=Unraid 共享模式
Unraid Share=Unraid 共享
Unraid Source Path=Unraid 源路徑
Updating=正在更新
USB Controller=USB 控制器
USB Devices=USB 設備
vDisk Bus=虛擬硬碟匯流排類型
vDisk Location=虛擬硬碟位置
vDisk Size=虛擬硬碟大小
vDisk Type=虛擬硬碟類型
vDisks vCDs=虛擬硬碟 / 虛擬光碟機
vDisks=虛擬硬碟
Verifying=驗證中
video for VM Console=虛擬機控制台的影片
video for VNC=VNC 影片
VirtIO Drivers CDRom Bus=包含 VirtIO 驅動程序的 CD-ROM 設備匯流排類型
VirtIO Drivers ISO=包含 VirtIO 驅動程序的 ISO 鏡像
Virtiofs Mode=VirtIOFS 模式
Virtual Machines=虛擬機
Virtual=虛擬
VM Being Cloned=正在複製的虛擬機
VM Being removed=正在移除的虛擬機
VM Clone=虛擬機複製
VM Console AutoPort=自動選擇虛擬控制台埠
VM Console enable Copypaste=啟用虛擬控制台拷貝/黏貼
VM Console Keyboard=虛擬控制台鍵盤
VM Console Password=虛擬控制台密碼
VM Console Port=虛擬控制台埠號
VM Console Protocol=虛擬控制台協議
VM Console Video Driver=虛擬控制台影片驅動
VM Console WS Port=虛擬機控制台 WS 埠
VM creation error=虛擬機創建錯誤
VM image deletion error=虛擬機鏡像刪除錯誤
VM Name=虛擬機名稱
VM Usage Statisics=虛擬機使用情況統計
VNC Keyboard=VNC 鍵盤
VNC Password=VNC 密碼
VNC Video Driver=VNC 影片驅動程序
VNC=VNC
Warning removing Snapshots can break the chain=警告：刪除快照可能會破壞鏈條
Wasnt able to stop the process=無法停止該進程
Web UI to start from menu=從菜單啟動網頁圖形界面
Web UI to start=網頁圖形界面啟動
WebUI=網頁圖形界面
Windows 7XP=Windows 7/XP
Windows 82012, newer Linux distros=Windows 8/2012，新 Linux 發行版
wsport for virtual console=虛擬控制台的WS埠
XML View=XML 視圖

; Note: May 31, 2025 - 34 missing translations
Configure the same IP address on the ipvtap interface=
Configure the VM with a static IP address=
Deselect All=
Disk capacity has to be greater than %s=
Displays and RAM=Display(s) and RAM
Driver=
Error occured=
Export User Template=
File for import=
GPU is primary adapter, vbios may be required=
Graphics ROM Needed=
Import from file=
Import=
Manual configuration required=
Manual Configuration Required=
Name contains invalid characters or does not start with an alphanumberic for a ZFS storage location=
Name contains invalid characters or does not start with an alphanumberic for a ZFS storage locationOnly these special characters are valid Underscore _ Hyphen - Colon Period=Name contains invalid characters or does not start with an alphanumberic for a ZFS storage location<br>Only these special characters are valid Underscore (_) Hyphen (-) Colon (:) Period (.)
No IP, guest agent not installed=
No pinning set=
nogpu=
Not enough free space, need at least %s MB=
Only one VM can be active at the time=
Pinned Cores=
Render GPU=
RenderGPU=
Save File Name=
Save Path=
Select All=
Select File=
Set SSD flag=
Template file write failed=
vCPUs=
virtual=
VM Usage Statistics=
